
WE    xpm/Bricks_w.xpm

F 230,100,100
C 225,30,0
NO xpm/Bricks_n.xpm

WE    xpm/Bricks_e.xpm


SO xpm/Bricks_s.xpm
EA xpm/Bricks_e.xpm

11111111111111111111111111
100000000001 1000000000001
11111011111111111111111111
1000000W0001  
111111111111
                      
