
NO xpm/Bricks_n.xpm
SO xpm/Bricks_s.xpm
WE xpm/Bricks_w.xpm
EA xpm/Bricks_e.xpm

F 230,255,255
C 225,30,255
                      
        1111111111111111111111111
        1000000000110000011100001
        101100000111000001 100001
        1001000000000000011100001
111111111011000001110000000000001
100000000011000001110111111111111
11110111111111011100000010001
11110111111111011101010010001
11000000110101011100000010001
11111111111111111111111111111
10000000000000001100000010001
10000000000N000011001001000011
11000000000000000000000000011
11110111111101011101111010001
11111111 1111111 111111111111
