
NO xpm/test.xpm
SO xpm/test.xpm
WE xpm/test.xpm
EA xpm/test.xpm kfsdjkf

F 0,0,0
C 255,255,255
                      
        1111111111111111111111111
        1000000000110000011100001
        101100000111000001 100001
        1001000000000000011100001
111111111011000001110000000000001
100000000011000001110111111111111
11110111111111011100000010001
11110111111111011101010010001
1100000011010101110000N010001
11111111111111111111111111111
10000000000000001100000010001
10000000000000001100100100001
11000000000000000000000000011
11110111111101011101111010001
11111111 1111111 111111111111
